%%%%%%%%%%%%%%%%%%%%%%%%%%%%%%%
%.%.........%% G %  o%%%%.....%
%.%.%%%%%%%.%%%%%% %%%%%%%.%%.%
%....G.......%...%.......G....%
%%%%%...%%%.. GG  ..%.%...%.%%%
%o%%%.%%%%%.%%%%%%%.%%%.%.%%%%%
%    ..........Po...%...%.   o%
%%%%%%%%%%%%%%%%%%%%%%%%%%%%%%%
