%%%%%%%%%%%
%P%  % %  %
% % %.% . %
%  o  .   %
% %   % . %
%   % % % %
%  % %   %%
% %  % %  %
%   % G   %
% %o  %   %
%%%%%%%%%%%