%%%%%%%%%%%%%%%%%%%
%P% %  %  % %  %  %
%   % % %% %   %  %
% % %   %  % % %  %
%   %   % %   %   %
% %%  % % % % % % %
% %   % % % %   % %
%  % %   % %  % o %
% %  %   %  %  % G%
%   % % %  %  %   %
% %  % %  %  %  % %
%   % o  %   % %  %
% %  %   %   %  % %
% G   %   % % %   %
%%%%%%%%%%%%%%%%%%%
