%%%%%%%%%%%%%%%%%%%%%%%%%%%%%%%
%.....%.................%.....%
%.%%%.%.%%%.%%%%%%%.%%%.%.....%
%.%...%.%......%......%.%..o..%
%...%%%.%.%%%%.%.%%%%...%%%...%
%%%.%.%.%.%......%..%.%...%.%%%
%...%.%%%.%.%%% %%%.%.%%%.%...%
%.%%%...0...%%GG  %.......%%%.%
%...%.%%%%%.%%%%%%%.%.%%%.%...%
%%%.%...%.%....%....%.%...%.%%%
%...%%%.%.%%%%...%%%%.%.%%%...%
%...0....%....o..%....%.....%.%
%.....%%...%%%%%%..%%%..%.%%%.%
%.....%........P....%...%.....%
%%%%%%%%%%%%%%%%%%%%%%%%%%%%%%%
