%%%%%%%%%%%%%%%%%%%%
%..G%...%o.....%..%%
%.%%....%..%%..%...%
%....%%G.........%%%
%o%%...%%....%%....%
%..%%..P...........%
%%%%%%%%%%%%%%%%%%%%